1 1 7 2 6 1 1 1 1 1 1 1 1 1 1 1 1 1 1 1
1 0 7 2 6 0 0 0 0 0 0 0 0 0 0 0 0 0 0 1
1 0 7 2 6 0 0 0 0 0 0 0 0 0 0 0 0 0 0 1
1 0 7 2 6 0 0 0 0 0 0 0 0 0 0 0 0 0 0 1
1 0 7 2 8 9 9 9 9 9 9 9 9 9 9 9 9 9 9 1
1 0 7 2 2 2 2 2 2 2 2 2 2 2 2 2 2 2 2 1
1 0 7 2 3 4 4 4 4 4 4 4 4 4 4 4 4 4 4 1
1 0 7 2 6 0 0 0 0 0 0 0 0 0 0 0 0 0 0 1
1 0 7 2 6 0 0 31 0 0 0 0 0 0 0 0 0 0 0 1
1 0 7 2 6 0 0 0 0 31 0 0 0 0 0 0 31 0 0 1
1 0 7 2 6 0 0 0 0 0 0 0 0 0 0 0 0 0 0 1
1 0 7 2 6 0 0 0 31 0 0 0 0 31 0 0 0 0 0 1
1 0 7 2 6 0 0 0 0 0 0 0 0 0 0 0 0 0 0 1
1 0 7 2 6 0 0 31 0 0 0 0 0 31 0 0 0 0 0 1
1 0 7 2 6 0 0 0 0 0 0 0 0 0 0 0 0 0 0 1
